{
  "id": "level4",
  "name": "Candy Kingdom",
  "description": "An expansive 15x15 board with complex candy formations!",
  "grid": [
    ["X", "X", "X", "1", "1", "X", "X", "X", "X", "X", "6", "6", "6", "X", "X"],
    ["X", "1", "1", "1", "1", "X", "X", "X", "X", "6", "6", "0", "6", "6", "X"],
    ["1", "1", "0", "0", "1", "X", "X", "X", "X", "6", "0", "0", "0", "6", "X"],
    ["1", "0", "0", "0", "0", "0", "0", "0", "0", "0", "0", "0", "0", "0", "X"],
    ["X", "0", "0", "0", "0", "0", "0", "0", "0", "0", "0", "0", "0", "0", "X"],
    ["X", "0", "0", "0", "2", "2", "2", "0", "0", "0", "0", "0", "0", "0", "X"],
    ["X", "0", "0", "2", "2", "0", "2", "2", "0", "0", "0", "0", "0", "0", "X"],
    ["X", "0", "0", "2", "0", "0", "0", "2", "0", "0", "7", "7", "7", "0", "X"],
    ["X", "0", "0", "2", "2", "2", "2", "2", "0", "0", "7", "0", "7", "0", "X"],
    ["X", "0", "0", "0", "0", "0", "0", "0", "0", "0", "7", "7", "7", "0", "X"],
    ["X", "0", "0", "0", "0", "0", "0", "0", "0", "0", "0", "0", "0", "0", "X"],
    ["X", "3", "3", "3", "0", "0", "0", "0", "0", "0", "0", "5", "5", "5", "X"],
    ["X", "3", "0", "3", "0", "0", "0", "0", "0", "0", "5", "5", "0", "5", "X"],
    ["X", "3", "3", "3", "0", "0", "4", "4", "4", "4", "5", "0", "0", "5", "X"],
    ["X", "X", "X", "X", "X", "4", "4", "0", "0", "4", "4", "5", "5", "5", "X"]
  ]
} 