{
  "id": "level5",
  "name": "Sweet Symphony",
  "description": "A massive 20x20 puzzle with intricate candy patterns!",
  "grid": [
    ["X", "X", "X", "X", "X", "X", "X", "1", "1", "1", "1", "X", "X", "X", "X", "X", "9", "9", "9", "X"],
    ["X", "X", "X", "X", "X", "X", "1", "1", "0", "0", "1", "1", "X", "X", "X", "9", "9", "0", "9", "X"],
    ["X", "X", "X", "X", "X", "1", "1", "0", "0", "0", "0", "1", "X", "X", "X", "9", "0", "0", "9", "X"],
    ["X", "X", "X", "X", "X", "1", "0", "0", "0", "0", "0", "1", "X", "X", "X", "9", "9", "9", "9", "X"],
    ["X", "X", "X", "X", "X", "1", "1", "1", "1", "1", "1", "1", "X", "X", "X", "X", "X", "X", "X", "X"],
    ["X", "X", "X", "X", "X", "X", "X", "X", "X", "X", "X", "X", "X", "X", "X", "X", "X", "X", "X", "X"],
    ["X", "2", "2", "2", "X", "X", "X", "X", "X", "X", "X", "X", "X", "X", "8", "8", "8", "8", "X", "X"],
    ["2", "2", "0", "2", "2", "X", "X", "X", "X", "X", "X", "X", "X", "8", "8", "0", "0", "8", "8", "X"],
    ["2", "0", "0", "0", "2", "X", "X", "X", "X", "X", "X", "X", "X", "8", "0", "0", "0", "0", "8", "X"],
    ["2", "2", "0", "2", "2", "X", "X", "X", "X", "X", "X", "X", "X", "8", "8", "0", "0", "8", "8", "X"],
    ["X", "2", "2", "2", "X", "X", "X", "X", "X", "X", "X", "X", "X", "X", "8", "8", "8", "8", "X", "X"],
    ["X", "X", "X", "X", "X", "X", "X", "X", "X", "X", "X", "X", "X", "X", "X", "X", "X", "X", "X", "X"],
    ["X", "X", "X", "X", "X", "X", "X", "X", "X", "X", "X", "X", "X", "X", "X", "X", "X", "X", "X", "X"],
    ["X", "3", "3", "3", "3", "X", "X", "X", "X", "0", "0", "0", "0", "X", "X", "X", "7", "7", "7", "X"],
    ["3", "3", "0", "0", "3", "X", "X", "X", "0", "0", "0", "0", "0", "0", "X", "7", "7", "0", "7", "7"],
    ["3", "0", "0", "0", "3", "X", "X", "0", "0", "6", "6", "6", "0", "0", "0", "7", "0", "0", "0", "7"],
    ["3", "3", "0", "0", "3", "X", "0", "0", "6", "6", "0", "6", "6", "0", "0", "7", "7", "0", "7", "7"],
    ["X", "3", "3", "3", "3", "0", "0", "0", "6", "0", "0", "0", "6", "0", "0", "0", "7", "7", "7", "X"],
    ["X", "X", "X", "X", "0", "0", "0", "0", "6", "6", "6", "6", "6", "0", "0", "0", "0", "X", "X", "X"],
    ["X", "X", "X", "X", "X", "0", "0", "0", "0", "0", "0", "0", "0", "0", "0", "0", "X", "X", "X", "X"]
  ]
} 