{
  "id": "level3",
  "name": "Sugar Rush",
  "description": "A challenging 10x10 board with multiple candy pieces!",
  "grid": [
    ["X", "1", "1", "1", "X", "X", "3", "3", "3", "X"],
    ["1", "1", "0", "1", "X", "3", "3", "0", "3", "3"],
    ["1", "0", "0", "0", "0", "0", "0", "0", "0", "3"],
    ["X", "0", "0", "0", "0", "0", "0", "0", "0", "X"],
    ["X", "2", "2", "0", "0", "0", "0", "4", "4", "X"],
    ["X", "2", "0", "0", "0", "0", "0", "0", "4", "X"],
    ["2", "2", "0", "0", "0", "0", "0", "0", "4", "4"],
    ["2", "0", "0", "0", "0", "0", "0", "0", "0", "4"],
    ["X", "0", "0", "5", "5", "5", "5", "0", "0", "X"],
    ["X", "X", "5", "5", "0", "0", "5", "5", "X", "X"]
  ]
} 